nameapp = ClisteAI
nameHome = CListe
nameAI = AI
introtexto = Regístrate en
signinup = Continuar con
google = Google
mail = Correo
seleclanguage = Selecciona el idioma
termandcon = Términos y condiciones
textAccept = Acepto los
textAceptPersonaldata = Acepto expresamente la autorización de
personaldataandpyp = tratamiento de datos personales de IntellyDev y política de privacidad
accepttext = Aceptar
addmailtext = Agrega tu correo
addmailhinttext = Tu Correo
addpasswordtext = ¿Qué contraseña escogerás?
addpasswordhinttext = Tu contraseña
addnametext = ¿Cuál es tu nombre?
addnamehinttext = Tu nombre
addlastnametext = ¿Cuál es tu Apellido?
addlastnamehinttext = Tu apellido
entermailtext = Ingresa tu correo
entermailhinttext = Tu correo
enterpasswordtext = Ingresa tu contraseña
enterpasswordhinttext = Tu contraseña
acquisitionwebtitle = Sitio Web
acquisitionwebsubtitle = ¿Ya has adquirido tu sitio web en ClisteAI?
acquisitionwebtext = Si ya has adquirido un sitio web en ClisteAI, simplemente ingresa la URL proporcionada. De lo contrario, al acceder a la plataforma, notaremos que la URL no está registrada en nuestra base de datos y te sugeriremos los pasos necesarios para completar el proceso de adquisición.
acquisitionwebAcceptbottom = ¡Sí, tengo uno!
acquisitionwebRechazedbottom = No, aún no tengo.
acceptacquisitionwebText = ¿Cuál es tu url de sitio?
acceptacquisitionwebhinttext = sitioweb.com
hometitle = Tus proyectos
appbarcoinname = C$
buttombarhomebottomtext = Inicio
buttombarstatsbottomtext = Estadisticas
buttombarprofilebottomtext = Perfil
newproyectTitle = Nuevo proyecto
newproyectuploadimage = Subir imagen
cameraselect = Tomar una foto
galleryselect = Subir imagen
newproyectnametext = Nombre del proyecto
newproyectnamehinttext = Ingresa el nombre...
newproyectselecttype = Selecciona el tipo de proyecto
newproyectselecttext = Seleccionar
selecttypeprojecttitle = Selecciona el tipo de proyecto
supporttext = Soporte
moderationtext = Moderación
bookingtext = Reservas
ecommercetext = Ecommerce
detailsprojecttabchats = Conversaciones
detailsprojecttabimplementations = Implementaciones
detailsprojecttabsettings = Configuraciones
detailsprojectfiltersall = Todos
detailsprojectfiltersonlywhatsapp = Solo Whatsapp
detailsprojectfiltersonlydiscord = Solo Discord
detailsprojectfiltersonlyWebchat = Solo WebChat's
detailsprojectimplementationtitleWhatsapp = Whatsapp
detailsprojectimplementationdescriptionWhatsapp = La implementación de WhatsApp permitirá que tu bot funcione a través de un número de teléfono registrado en WhatsApp.
detailsprojectimplementationtitleDiscord = Discord
detailsprojectimplementationdescriptionDiscord = La implementación de Discord permitirá que tu bot funcione a través de un servidor de Discord.
detailsprojectimplementationtitleWeb = Web
detailsprojectimplementationdescription = Este servicio solo se puede configurar y activar desde el panel web de ClisteAI.
chatstitletypeWhatsapp = Whatsapp
chatstitletypeDiscord = Discord
chatstitletypeWeb = WebChat
chatsbottomunlockchat = Desbloquear conversación
chatswaitingresponse = Esperando respuesta
chatshinttext = Mensaje...
chatsdaterecent = Hace un momento
chatsdaterecents = Hace
chatshour = Horas
chatsMinute = Minutos